###################################################################################################
#                                                                                                 #
#                                                                                                 #
#                                                                                                 #
#                                                                                                 #
#                                                                                                 #
#                #                                                           #                    #
#                                                                                                 #
#                                                                                                 #
#                                                                                                 #
#                                                                                                 #
#                                                                                                 #
#                                         ################                                        #
#                                                                                                 #
#                                                                                                 #
#                                                                                                 #
#                                                                                                 #
#                                         #               #                                       #
#                                         #               #                                       #
#                                         #               #                                       #
#                                         #               #                                       #
#                                         #               #                                       #
#                                         #               #                                       #
#                                                                                                 #
#                                                                                                 #
#                                         ################                                        #
#                                                                                                 #
#                                                                                                 #
#                                                                                                 #
#                                                                                                 #
#                                                                                                 #
#                                                                                                 #
#            #                                                    #                               #
#                                                                                                 #
#                                                                                                 #
#                                                                                                 #
#                                                                                                 #
#                                                                                                 #
#                                                                                                 #
#                                                  #                                              #
#                                                                                                 #
#                                                                                                 #
#                                                                                                 #
#                                                                                                 #
#                                                                                                 #
#                                                                                                 #
#                                                                                                 #
###################################################################################################