###################################################################################################
#                                                                                                 #
#                                                                                                 #
#                                                                                                 #
#                                                                                                 #
#                                                                                                 #
#                                                                                                 #
#                                                                                                 #
#                                                                                                 #
#                                                                                                 #
#                                                                                                 #
#                                                                                                 #
#                                                                                                 #
#                                                                                                 #
#                                                                                                 #
#                                                                                                 #
#                                                                                                 #
#                                                                                                 #
#                                                                                                 #
#                                                                                                 #
#                                                                                                 #
#                                                                                                 #
#                                                                                                 #
######################################## ############ #############################################
#                                                                                                 #
#                                                                                                 #
#                                                                                                 #
#                                                                                                 #
#                                                                                                 #
#                                                                                                 #
#                                                                                                 #
#                                                                                                 #
#                                                                                                 #
#                                                                                                 #
#                                                                                                 #
#                                                                                                 #
#                                                                                                 #
#                                                                                                 #
#                                                                                                 #
#                                                                                                 #
#                                                                                                 #
#                                                                                                 #
#                                                                                                 #
#                                                                                                 #
#                                                                                                 #
#                                                                                                 #
#                                                                                                 #
###################################################################################################